NO ./path_to_the_west_texture1
SO ./ab
EA  ./a
WE ./path_to_the_west_texture12


F       220 , 100 , 2
    C   222 ,   30 ,  6

11111111111111111  
11111         1
1111011111111111111111111
1000000000110000000000001
101100001110000000000001111             
100101110000000000000000000111111       
1111111110110000011100000000000011111111
10000000001100001 1011101111111111111111111
1111011111111101110000001000111111101111
11111111111111111111111111101    1111111
11111111111111111111111111111 
111111111111111111111111111111111
  11111111110111111111011101010011111
111100000011010101110000001000111
10000000000S000011000000100011
10000000000000001101010010001
1100000111010101 11101111110111
11110111 1110101 101111010001
11111111111111111111111111111