NO ./textures/wall_bonus.xpm
SO ./textures/wall_2.xpm
EA ./textures/apple.xpm
WE ./textures/wall_4.xpm


F       177 , 86 ,   4
    C   19, 243,239

11111111111111111 
11111         1
1111011111111111111111111
1000000000110000000000001
101100001110000000000001111             
100101110000000000000000000111111       
1111111110110000011100000000000011111111111
10000000001100001 1011101111111111111111101
1111011111111101110000001000111111101111111
11111111111111111111111111101    1111111
11111111111111111111111111111
111111111111111111111111111111111
  11111111110111111111011101010011111
111100000010010101110000001000111
100000000000000011000000100011
100S0000000000001101010010001
1100000111010101 11101111110111
11110111 1110101 101111010001
11111111111111111111111111111