NO ./textures/wall_bonus.xpm
WE ./textures/wall_4.xpm
EA ./textures/apple.xpm
SO ./textures/wall_2.xpm

F 6,56 ,255
C 74, 34,39


1111111
1001011
1010011
110001N
1111111
